###########################################################
#^^^^^^^^^^^^^^^^^^^^^^^^^^^^^^^^^^^^^^^^^^^^^^^^^^^^^^^^^#
#^     ^^^^       ^^^^^^^^^^^^^^^^^^^^^^^^^^^^^^^^^^^ ^^^^#
#^                  ^^^^^^^^^^^^^^^^^^^^^^^^^^^^^^^^ $ ^^^#
#^     ^^^^      ^   ^^^^^^^^^^^^^^^^^^^^^^^^^^^^^^     ^^#
#^^^^^^^            ^^^^^^^^^^^^^^^^^^^^^^^^^^^^^        ^#
#^        ^         ^^^^^^^^^^^^^^^^^^^^^^^^^^^^         ^#
#^  ^              ^ ^^^^^^^^^^^^^^^^^^^^^^^^^^^         ^#
#^ ^^^  ^            ^^^^^^^^^^^^^^^^^^^^^^^^^^^         ^#
#^  ^         ^        ^^^^^^^^^^^^^^^^^^^^^^^^^#### ####^#
#^                       ^^^^^^^^^^^^^^^^^^^^^^^#       #^#
#^^^      ^      ^             ^     ^^^^^^^^^^^#  #### #^#
#^^^                                        ^^^^#  #    #^#
#^  ^         ^                                ^#### ####^#
#^                      ^                           *   #^#
#^     ^^^^^^^          ^^^^     ^^ ^           #########^#
#^^^^^^^^^^^^^^^^^^^^^^^^^^^^^^^^^^^^^^^^^^^^^^^^^^^^^^^^^#
###########################################################
