###########################################################
#^^^^^^^^^^^^^^^^^^^^^^^^^^^^^^^^^^^^^^^^^^^^^^^^^^^^^^^^^#
#^     ^^^^       ^^^^^^^^^^^^^^^^^^^^^^^^^^^^^^^^^^^ ^^^^#
#^                  ^^^^^^^^^^^^^^^^^^^^^^^^^^^^^^^^ $ ^^^#
#^     ^^^^      ^   ^^^^^^^^^^^^^^^^^^^^^^^^^^^^^^ ! ! ^^#
#^^^^^^^            ^^^^^^^^^^^^^^^^^^^^^^^^^^^^^ ! ! !  ^#
#^        ^         ^^^^^^^^^^^^^^^^^^^^^^^^^^^^         ^#
#^  ^              ^ ^^^^^^^^^^^^^^^^^^^^^^^^^^^   !!!   ^#
#^ ^^^  ^            ^^^^^^^^^^^^^^^^^^^^^^^^^^^      !  ^#
#^  ^         ^        ^^^^^^^^^^^^^^^^^^^^^^^^^#### ####^#
#^                       ^^^^^^^^^^^^^^^^^^^^^^^#       #^#
#^^^      ^      ^             ^ !   ^^^^^^^^^^^#  #### #^#
#^^^                                        ^^^^#  #    #^#
#^  ^         ^                             !! ^#### ####^#
#^                      ^      !                    *   #^#
#^     ^^^^^^^          ^^^^     ^^ ^       !   #########^#
#^^^^^^^^^^^^^^^^^^^^^^^^^^^^^^^^^^^^^^^^^^^^^^^^^^^^^^^^^#
###########################################################
