  ###########################################################
            #   # #     # #   #   # #     #                 #
# # # # # ### # # # ### # # # # ### # # ######### ### #######
# # # # #     # #     # #   # #   #   #   #       # #       #
### ### # ### # ### ##### ### ### # ##### # ####### ### ### #
# #   # #   # #             #         #             # # # # #
# # # ##### # ######### ##### # ####### # # ### ### # ### ###
#   #   # # # # #     #   # # # #     # # #   # #         # #
# # # ### # ### # ##### # # ##### ##### ### # # ######### # #
# # # # #     # #     # # # # #   # #   #   # # #           #
##### # ####### ### ### ### # # ### ### ### # # ##### ##### #
# #   #   #           # #   # #         #   # # # # #   #   #
# ### # ##### # # ####### ### # ############### # # ##### ###
#   #   #     # # # #   # #       #     #   #   #   # #     #
# # # ####### ### # ### # ##### # # # ##### # ### # # #######
# # #   #   # #   #           # # # # #       #   #   # #   #
# ### ### ### # ####### ##### # # # # # ##### # # # # # # # #
#     #       #         #       #   # #     #   # # #     #*#
#############################################################