#############################################################
#     #  #           #           #     #  #     #  #  #     #
#  ####  #  #  #  #  ####  ####  #  ####  #  #  #  #  ####  #
#  #     #  #  #  #  #        #        #  #  #     #        #
#  #  #######  ###################  ####  ####  #  #  ####  #
#           #     #     #  #     #              #     #     #
####  ##########  #  ####  #  ####  ##########  ####  ####  #
#  #  #              #  #              #  #  #     #     #  #
#  #  #  #  #  #######  #  #######  ####  #  #######  #  ####
#     #  #  #                 #     #  #  #     #  #  #     #
#  ####  ####  ####  #######  #######  #  ####  #  #  #######
#           #  #     #     #              #  #     #  #  #  #
####  ##########  ####  ####  ####  #######  ####  #  #  #  #
#        #        #  #        #  #        #     #           #
####  ##########  #  #######  #  #  #######  #######  #  ####
#        #  #              #  #     #  #  #           #     #
#  #  ####  #############  #  #  #  #  #  #  ####  #######  #
#  #                    #  #  #  #  #        #        #    *#
#############################################################