  #######################################
    # #       #       #   # #   # # #   #
# ### # # # # ### ### # ### # # # # ### #
# #   # # # # #     #     # # #   #     #
# # ##### ############# ### ### # # ### #
#       #   #   # #   #         #   #   #
### ####### # ### # ### ####### ### ### #
# # #         # #         # # #   #   # #
# # # # # ##### # ##### ### # ##### # ###
#   # # #           #   # # #   # # #   #
# ### ### ### ##### ##### # ### # # #####
#       # #   #   #         # #   # # # #
### ####### ### ### ### ##### ### # # # #
#     #     # #     # #     #   #       #
### ####### # ##### # # ##### ##### # ###
#     # #         # #   # # #       #   #
# # ### ######### # # # # # # ### ##### #
# #             # # # # #     #     #  *#
#########################################