#############################################################
# #       # #     #               #     #           #     # #
# ##### ### ##### ####### ### # # # # ### ### ### ##### ### #
# #     #   #     #         # # #   # #   #     # #   #     #
# # # ##### ##### ### ##### # ####### # ##### # # # ### ### #
#   # # #       #       # # #     #   #   # # # # #   # # # #
# ##### # ### ##### ##### # ### # ##### ### # # ### # # # ###
#   # #   # #     # # #       # #   #   # #   #     #       #
# ### ##### # ### # # # ### # ### ### ### # # ### # ### #####
#         #     #     # #   #   #   #   # # #   # # #       #
##### # # # ##### ##### ####### ### # ### ######### # ##### #
#     # #     #   # #   # #   # # #   #     #       # #     #
# ####### # ####### # ### ### ### # # ##### ### ##### ### ###
#   #   # #       #       #   #     # # # # # #     #   #   #
# # ### ##### ##### ### # ### ### ##### # # # ##### ##### # #
# # #     #     #   #   #   # #   #     #       #       # # #
### # ####### ##### # # # # # ### # ### # ####### ##### # # #
#     #       #     # # # #   #       #       #       # # #*#
#############################################################