  #######################################
  #       # #     #   # #   #     # #   #
# ### ### # ##### # ### # ####### # # ###
#       # #   #             #     #     #
### ######### ### # ######### ### # #####
#       #   #   # #     # #     # #     #
##### ### ##### # ####### # ##### ### # #
#       #         # #   #   #   #   # # #
# ##### ##### # # # # # ### ### ####### #
#   #   # #   # # # # #     #   #       #
# # ### # # # # ### ##### # # ### ### ###
# #   #     # # # # # #   #   #   # #   #
### ### ##### # # # # ### # # # ### # ###
#   # #   #   # # #   #   # #     #     #
# ### ##### ##### ### # # # # # ##### ###
#     # #   #   #   # # # # # #   #     #
# # # # # ### # ### # ### ##### ##### ###
# # # #       #           #     #      *#
#########################################