#############################################################
#  #           #  #        #     #  #     #        #  #     #
#  ####  ####  #  #######  #  ####  #  ##########  #  #  ####
#           #  #     #                    #        #        #
####  #############  ####  #  #############  ####  #  #######
#           #     #     #  #        #  #        #  #        #
#######  ####  #######  #  ##########  #  #######  ####  #  #
#           #              #  #     #     #     #     #  #  #
#  #######  #######  #  #  #  #  #  ####  ####  #########   #
#     #     #  #     #  #  #  #  #        #     #           #
#  #  # ##  #  #  #  #  ####  #######  #  #  ####  ####  ####
#  #     #        #  #  #  #  #  #     #     #     #  #     #
####  ####  #######  #  #  #  #  ####  #  #  #  ####  #  ####
#     #  #     #     #  #  #     #     #  #        #        #
#  ####  #######  #######  ####  #  #  #  #  #  #######  ####
#        #  #     #     #     #  #  #  #  #  #     #        #
#  #  #  #  #  ####  #  ####  #  ####  #######  #######  ####
#  #  #  #           #                 #        #          *#
#############################################################