########################################
#  #        #                    #     #
#  ####  ####  #  #######  #  #  #  #  #
#  #  #        #     #     #  #     #  #
#  #  #######  #  ################  #  #
#           #  #        #  #  #     #  #
#  #######  #############  #  #  #  ####
#     #     #  #  #  #  #        #     #
#  #######  #  #  #  #  #  #######  ####
#     #        #  #     #  #     #     #
#######  ####  #  ####  #  #  #######  #
#     #  #     #  #  #  #  #           #
####  ####  ####  #  #  #  #  #  ####  #
#     #              #     #  #     #  #
#  ####  ####  #######  #  ####  #######
#     #     #  #        #  #           #
#  #  ####  #  ####  #  #######  #  ####
#  #        #        #        #  #    *#
########################################