########################################
#  #  #  #  #                          #
#  #  #  #  #  ####  #  #######  #  #  #
#                 #  #        #  #  #  #
#  #  ####  #  ####  ################  #
#  #     #  #     #  #  #     #        #
####  ####  ##########  #  #  #######  #
#  #     #  #     #        #        #  #
#  ####  #######  #  #######  ##########
#                       #  #  #        #
#  #  #############  ####  #  #  ####  #
#  #     #  #     #  #  #        #     #
#  #######  #  #######  #  ####  ####  #
#  #     #        #  #  #     #  #  #  #
#  ####  ####  #  #  #  #  #  #  #  #  #
#     #     #  #        #  #  #  #     #
####  ####  #  ####  #  #######  #######
#     #        #     #                *#
########################################